R 1920 1580
NO ./path_of_north_wall
SO ./path_of_south_wall
WE ./path_of_west_wall
EA ./path_of_east_wall
S ./path_of_sprite

F 0,100,170
C 255,105,120

111111111111
10010000000111
100000100111
1111000001
1000000111
1000000001
1001000101
1010000101
1000000001
1111111111