R 1920 1080
NO ./path_of_north_wall
SO ./path_of_south_wall
WE ./path_of_west_wall
EA ./path_of_east_wall
S ./path_of_sprite

F 0,100,170
C 255,105,120
11111111111111
10000000010011
11100000000001
10001011100011
10001010000001
10001111100001
10000010100101
10001110100001
10000000000001
11111111111111