R 1000 1000
NO ./path_of_north_wall
SO ./path_of_south_wall
WE ./path_of_west_wall
EA ./path_of_east_wall
S ./path_of_sprite

F 0,100,170
C 255,105,120
11111111111111
10000000010011
11100000000N1
10001000000011
10010010000001
10010110010001
10010000100101
10001111000001
10000000000001
11111110001111
	  1001
      101
    110011111
 111100000000111
1000001111110001
11000011  100111
101000001 1000101
10000000010010001
10000000000010001
11111111111111111111