R 1920 1080
NO ./path_of_north_wall
SO ./path_of_south_wall
WE ./path_of_west_wall
EA ./path_of_east_wall
S ./path_of_sprite

F 0,100,170
C 255,105,120
11111111111111
10000000010011
111N0000000001
10001000000011
10010010000001
10010110010001
10010000100101
10001111000001
10000000000001
11111110001111
	  1001
      101
    11001
 111100001  1111
100001111  10001
11000011  10011
101000001 1001 1
10000000010000101
10000000000000001
11111111111111111