R 1000 1000
WE ./textures/wall3.xpm
EA ./textures/wall5.xpm
NO ./textures/wall2.xpm
SO ./textures/wall4.xpm

F 165, 158, 151
C		114, 170, 216

                                       11111111111111111111111111111111111111111111111111111111111111
                                       10000000000000000000000000000000000000000000000000000000000001              
                                       10000000000000000000000010000000000011111111111111111111111111
                                       10000101010010000000000000000000000010001          
                                       10100000000001110000000000000000000000101         
                                       1000000001100100000001000000100000000001         
                                111 11100000100000001001000000000011000000000011          
                               100010000000000000000000001000010001000000000101           
                              1000000010001000010000000000000000001100001000001           
                              100000000000000000000110000010000000011000000001            
                              100001000110000001000110000110000000001100000001            
                              100000000000000001000100000000000010000000001001            
                               1000000000001000000110010001000010000000000111             
                             110000100010000000000100000010110000000011011                
                            10000000000000000000000000000001 100001111001                 
                           11010000000000100100010100000001  100000001101                 
                          100000100000000000000010100001001  100000001001                 
                      11  1000010000000111113111111110000001  1000000001                  
                     1001 1000000000001000000000000001110001   100001101                  
                     10001100001000001000N000001000001  111     11000101                  
                    100001000000000003000000000000001            1000001                  
                  1 10000000000000000100000000000001              11111                   
                 10110000000000001110111111111111111                                      
                 1001100000000000001001000110000011                                       
                1000010000000100000001000001100101                                        
                1100000000000000010100000000111001                                        
               1000011110110000000000000000010101                                         
               10111    1 10000010100100100000001                                         
               10101       1000000000001100000001                                         
              11010011 1   100000011001  1101001                                          
             100000010101  1000001  11 11100111                                           
             100000000001 11000001    1000001         11                          111     
             10100000000110101110011110000001        1001                        10001    
             10011000000110001110010000000001       1000111111                   1100111  
             1000000000010000000000000000000111     10000000001                 100000001 
            100000000011000011001000000000000001     10000001001              111000000001
           1100010000000000000001000000000000001    100000000001             1000000000001
          1000001000000000000000001100000101111    1100000000001             1000000000001
           10111000000100000000000000000000111   110000000000001              100100100001
           101  1111110010001000000000011000001 1000000000000001              10001110001 
          1001        1011010000000110011000001 1000000000000001             110001  101  
       1111001        101 11000110000001100000111000000000000001            100000111001  
      10000001        1011 10000000000000001000000001000010100001            10101100001  
       101111        10000110011001100000001000000011110111000001           10011 1011001 
      1001          1000001 100001  10000000000100000110001000001            1001100000001
      10101          111101  11101 1000000000001101000000010010001           1000000000001
      100011           1001     1 10000000000001000001000011110001         11 100010000001
       110001          101        1000000000000000000000001   111         1001000000000001
        10001         1001        1000010000000000000000011111        11 10000000000000001
      111011   1      1001        11000000000000000000000000001      100110000000000000001
     100001 111011111 1001       100000000000000000000000000001      10000000000000000011 
     10000110000000001 101      1000000011000000000000000000001    111000000000000000001  
      1011 1000000000011001      100001011000000000000000000001   1000000100000000000001  
      100011000000000011000111  100011 1  100000000000000000001   1000000000000000000001  
     11101100000001000100000001  111      1011000000000000111011111000000000000000000001  
    100000000000001100110001101           100111110000000011100000000100001100010000011   
  1100101100101100000001000011            10001 1000100000001110001100000001100000011     
 1000000011100000001111000001            100001 1000000100000001001100000001 1110001      
  10111001  10011000111101001       11    1100010000000000001001001100100001    1001      
   1  101    11  11000000100111    1001     1001000000011001 10001  10111001     11       
       1          1011101 10000111110001111 1000000011100000110001 11011011               
                   1   1 11010010000000000011000000011001000010011100000001               
                        100000000000000000000000000010001100011000001110001               
                        10111010010000100000000110001101000000000001 10001                
                         1   1100100001000000011 111000000100011000110001                 
                               100000110000000001  100000001001100001111                  
                               100100110010010101   10110000000000001                     
                                11 11 101 11 1100111000111011000000001                    
                                       1       10001110000000000000001                    
                                              100111111111000010011001                    
                                              1000100000000010111  11                     
                                               10010000000000011                          
                                                10000000001000001                         
                                                10000000001100001                         
                                                 1100000001 1111                          
                                                   10000001                               
                                                   1000001                                
                                                    110101                                
                                                      1 1     
						        